excuse	[iks'kju:z]	v.原谅
me	[mi:]	pron.我(宾格)
yes	[jes]	ad.是的
is	[iz]	v. be动词现在时第三人称单数
this	[θis]	pron.这
your	[jɒ:]	possessive adjective你的，你们的
handbag	['hændbæg]	n. (女用) 手提包
pardon	['pa:dn]	int.原谅，请再说一遍
it	[it]	pron.它
thank you		感谢你(们)
very much		非常地
pen	[pen]	n.钢笔
pencil	['pensl]	n.铅笔
book	[buk]	n.书
watch	[wɒtʃ]	n.手表
coat	[kəʊt]	n.上衣，外衣
dress	[dres]	n.连衣裙
skirt	[skз:t]	n.裙子
shirt	[ʃз:t]	n.衬衣
car	[ka:]	n.小汽车
house	[haus]	n.房子
umbrella	[ʌm'brelə]	n.伞
please	[pli:z]	int.请
here	[hıə]	ad.这里
my	[mai]	possessive adjective 我的
ticket	['tikit]	n.票
number	['nʌmbə]	n.号码
five	[faiv]	num. 五
sorry	['sɒri]	a.对不起的
sir	[sз:]	n.先生
cloakroom	['kləʊkru:m]	n.衣帽存放处
suit	[sju:t]	n.一套衣服
school	[sku:l]	n.学校
teacher	['ti:tʃə]	n.老师
son	[sʌn]	n.儿子
daughter	['dɒ:tə]	n.女儿
Mr.	['mistə]	先生
good	[gud]	a.好
morning	['mɒ:nıŋ]	n.早晨
Miss	[mis]	小姐
new	[nju:]	a.新的
student	['stju:dənt]	n.学生
French	[frentʃ]	a. & n.法国人
German	['dʒз:mən]	a. & n.德国人
nice	['nais]	a.美好的
meet	[mi:t]	v.遇见
Japanese	[dʒæpə'ni:z]	a. & n.日本人(的)
Korean	[kə'rıən]	a. & n.韩国人(的)
Chinese	['tʃai'ni:z]	a. & n.中国人(的)；汉语(的)
too	[tu:]	ad.也
make	[meik]	n. (产品的) 牌号
Swedish	['swi:diʃ]	a.瑞典的
English	['ıŋgliʃ]	a.英国的
American	[ə'merikən]	a.美国的
Italian	[i'tæljən]	a.意大利的
Volvo	['vɒlvə]	n.沃尔沃
Peugeot		n.标致
Mercedes		n.梅赛德斯
Toyota		n.丰田
Daewoo		n.大宇
Mini	['mini]	n.迷你
Ford	[fɒ:d]	n.福特
Fiat	['faiæt]	n.菲亚特
I		pron.我
am	[æm, əm]	v. be动词现在时第一人称单数
are	[a:]	v. be动词现在时复数
name	['neim]	n.名字
what	[wɒt]	a. & pron.什么
nationality	['næʃə'næliti]	n.国籍
job	[dʒɒb]	n.工作
keyboard	['kibɒ:d]	n.电脑键盘
operator	['ɒpəreitə]	n.操作人员
engineer	['endʒi'nıə]	n.工程师
policeman	[pə'li:smən]	n.警察
policewoman	[pə'li:s,wumən]	n.女警察
taxi driver		出租汽车司机
air hostess		空中小姐
postman	['pəʊstmən]	n.邮递员
nurse	[nз:s]	n.护士
mechanic	[mi'kænik]	n.机械师
hairdresser	['heədresə]	n.理发师
housewife	['hauswaif]	n.家庭妇女
milkman		n.送牛奶的人
hello	[he'ləʊ]	int.喂(表示问候)
hi	[hai]	int.喂，嗨
how	[hau]	ad.怎样
today	[tə'dei]	ad.今天
well	[wel]	a.身体好
fine	[fain]	a.美好的
thanks		int.谢谢
goodbye	[`gud'bai]	int.再见
see	[si:]	v.见
fat	[fæt]	a.胖的
woman	['wumən]	n.女人
thin	[ðin]	a.瘦的
tall	[tɒ:l]	a.高的
short	[ʃɒ:t]	a.矮的
dirty	['dз:ti]	a.脏的
clean	[kli:n]	a.干净的；
hot	[hɒt]	a.热的
cold	[kəʊld]	a.冷的
old	[əʊld]	a.老的
young	[jʌŋ]	a.年轻的
busy	['bizi]	a.忙的
lazy	['leizi]	a.懒的
whose	[hu:z]	pron.谁的
blue	[blu:]	a.蓝色的
perhaps	[pə'hæps]	ad.大概
white	[wait]	a.白色的
catch	[kætʃ]	v.抓住
father	['fa:θə]	n.父亲
mother	['mʌθə]	n.母亲
blouse	[blauz]	n.女衬衫
sister	[sistə]	n.姐，妹
tie	[tai]	n.领带；联系，关系；vt.扎，束紧
brother	['brʌθə]	n.兄，弟
his	[his]	possessive adjective 他的
her	[hз:, hə]	possessive adjective她的
colour	['kʌlə]	n.颜色
green	[gri:n]	a.绿色
come	[kʌm]	v.来
upstairs	[ʌp'stAəz]	ad.楼上
smart	[sma:t]	a.时髦的，巧妙的
hat	[hæt]	n.帽子
same	[seim]	a.相同的
lovely	['lʌvli]	a.可爱的，秀丽的
case	[keis]	n.箱子
carpet	['ka:pit]	n.地毯
dog	[dɒg]	n.狗
customs		n.海关
officer	['ɒfisə]	n.官员
girl	[gз:l]	n.女孩，姑娘
Danish	['deiniʃ]	a. & n.丹麦人
friend	[frend]	n.朋友
Norwegian	[nɒ:'wi:dʒən]	a. & n.挪威人
passport	['pa:spɒ:t]	n.护照
brown	[braun]	a.棕色的
tourist	['tuərist]	n.旅游者
Russian	['rʌʃən]	a. & n.俄罗斯人
Dutch	['dʌtʃ]	a. & n.荷兰人
these	[θi:z]	pron.这些
red	[red]	a.红色的
grey	[grei]	a.灰色的
yellow	['jeləʊ]	a.黄色的
black	[blæk]	a.黑色的
orange	['ɒrindʒ]	a.橘黄色的；n.橙
employee	['emplɒi'i:]	n.雇员
hard-working		a.勤奋的
sales reps		推销员
man	[mæn]	n.男人
office	['ɒfis]	n.办公室
assistant	[ə'sistənt]	n.助手
matter	['mætə]	n.事情
children	['tʃildrən]	n.孩子们
tired	['taıəd]	a.累，疲乏
boy	[bɒi]	n.男孩
thirsty	['ðз:sti]	a.渴
Mum	[mʌm]	n.妈妈
sit down		坐下
right	[rait]	a.好，可以；正确的
ice cream		冰淇淋
big	[big]	a.大的
small	[smɒ:l]	a.小的
open	['əʊpən]	a.开着的
shut	[ʃʌt]	a.关着的
light	[lait]	a.轻的
heavy	['hevi]	a.重的
long	[lɒŋ]	a.长的
shoe	[ʃu:]	n.鞋子
grandfather	['grænd'fa:θə]	n.祖父，外祖父
grandmother	['grænd'mʌθə]	n.祖母，外祖母
give	[giv]	v.给
one	[wʌn]	pron.一个
which	['witʃ]	pron.哪一个
empty	['empti]	a.空的；
full	[ful]	a.满的
large	[la:dʒ]	a.大的
little	['litl]	a.小的
sharp	[ʃa:p]	a.尖的，锋利的
small	[smɒ:l]	a.小的
big	[big]	a.大的
blunt	[blʌnt]	a.钝的
box	[bɒks]	n.盒子，箱子
glass	[gla:s]	n.杯子
cup	[kʌp]	n.茶杯
bottle	['bɒtl]	n.瓶子
tin	[tin]	n.罐头
knife	[naif]	n.刀子
fork	[fɒ:k]	n.叉子
spoon	[spu:n]	n.勺子
on	[ɒn]	prep.在……之上
shelf	[ʃelf]	n.架子，搁板
desk	[desk]	n.课桌
table	['teibl]	n.桌子
plate	[pleit]	n.盘子
cupboard	['kʌbəd]	n.食橱
cigarette		n.香烟
television	['teli'viʒən]	n.电视机
floor	[flɒ:]	n.地板
dressing table		梳妆台
magazine	['mægə'zi:n]	n.杂志
bed	[bed]	n.床
newspaper	['nju:z'peipə]	n.报纸
stereo	['stıəriəʊ]	n.立体声音响
Mrs.	['misiz]	夫人
kitchen	['kitʃin]	n.厨房
refrigerator	[ri'fridʒəreitə]	n.电冰箱
right	[rait]	n.右边
electric	[i'lektrik]	a.带电的，可通电的
left	[left]	n.左边
cooker	['kukə]	n.炉子，炊具
middle	['midl]	n.中间
of	[ɒv, əv]	prep. (属于)……的
room	[ru:m, rum]	n.房间
cup	[kʌp]	n.杯子
where	[wAə]	ad.在哪里
in	[in]	prep.在……里
living room		客厅
near	[nıə]	prep.靠近
window	['windəʊ]	n.窗户
armchair	['a:m'tʃAə]	n.手扶椅
door	[dɒ:]	n.门
picture	['piktʃə]	n.图画
wall	[wɒ:l]	n.墙
trousers		n. (复数) 长裤
shut	[ʃʌt]	v.关
bedroom	['bedrum]	n.卧室
untidy	[ʌn'taidi]	a.乱，不整齐
must	[mʌst]	modal verb必须，应该
open	['əʊpən]	v.打开
air	[Aə]	v.使……通风，换换空气
put	[put]	v.放置
clothes	[kləʊθz]	n.衣服
wardrobe	['wɒ:drəʊb]	n.大衣柜
dust	[dʌst]	v.掸掉灰尘
sweep	[swi:p]	v.扫
empty	['empti]	v.倒空，使……变空
read	[ri:d]	v.读
sharpen	['ʃa:pən]	v.削尖，使锋利
put on		穿上
take off		脱掉
turn on		开(电灯)
turn off		关(电灯)
garden	['ga:dn]	n.花园
under	['ʌndə]	prep.在……之下
tree	[tri:]	n.树
climb	[klaim]	v.爬，攀登
who	[hu:]	pron.谁
run	[rʌn]	v.跑
grass	[gra:s]	n.草，草地
after	['a:ftə]	prep.在……之后
across	[ə'krɒs]	prep.横过，穿过
cat	[kæt]	n.猫
type	[taip]	v.打字
letter	['letə]	n.信
basket	['ba:skit]	n.篮子
eat	[i:t]	v.吃
bone	[bəʊn]	n.骨头
clean	[kli:n]	v.清洗
tooth	[tu:ð]	n.牙齿(复数teeth)
cook	[kuk]	v.做(饭菜)
milk	[milk]	n.牛奶
meal	[mi:l]	n.饭，一顿饭
drink	[drıŋk]	v.喝
tap	[tæp]	n. (水) 龙头
day	[dei]	n.日子
cloud	[klaud]	n.云
sky	[skai]	n.天空
sun	[sʌn]	n.太阳
shine	[ʃain]	v.照耀
with	[wiθ]	prep.和......在一起
family	['fæmili]	n.家庭(成员)
walk	[wɒ:k]	v.走路，步行
over	['əʊvə]	prep.跨越，在......之上
bridge	[bridʒ]	n.桥
boat	[bəʊt]	n.船
river	['rivə]	n.河
ship	[ʃip]	n.轮船
aeroplane	['Aərəplein]	n.飞机
fly	[flai]	v.飞
sleep	[sli:p]	v.睡觉
shave	[ʃeiv]	v.刮脸
cry	[krai]	v.哭，喊
wash	[wɒʃ]	v.洗
wait	[weit]	v.等
jump	[dʒʌmp]	v.跳
photograph	['fəʊtəgra:f]	n.照片
village	['vilidʒ]	n.村庄
valley	['væli]	n.山谷
between	[bi'twi:n]	prep.在......之间
hill	[hil]	n.小山
another	[ə'nʌθə]	另一个
wife	[waif]	n.妻子
along	[ə'lɒŋ]	prep.沿着
bank	[bæŋk]	n.河岸
water	['wɒ:tə]	n.水
swim	[swim]	v.游泳
building	['bildıŋ]	n.大楼，建筑物
park	[pa:k]	n.公园
into	['intu, 'intə]	prep.进入
beside	[bi'said]	prep.在......旁
off	[ɒ:f]	prep.离开
work	[wз:k]	v.工作
hard	['ha:d]	ad.努力地
make	[meik]	v.做
bookcase	['bukkeis]	n.书橱，书架
hammer	['hæmə]	n.锤子
paint	[peint]	v.上漆，涂
pink	[pıŋk]	n. & a.粉红色
favourite	['feivərit]	a.最喜欢的
homework	['həʊmwз:k]	n.作业
listen	['lisn]	v.听
dish	[diʃ]	n.盘子，碟子
front	[frʌnt]	n.前面
in front of		在......之前
careful	['kAəful]	a.小心的，仔细的
vase	[va:z]	n.花瓶
drop	[drɒp]	v.掉下
flower	['flauə]	n.花
show	[ʃəʊ]	v.给......看
send	[send]	v.送给
take	[teik]	v.带给
cheese	[tʃi:z]	n.乳酪，干酪
bread	[bred]	n.面包
soap	[səʊp]	n.肥皂
chocolate	['tʃɒkəlit]	n.巧克力
sugar	['ʃugə]	n.糖
coffee	['kɒfi]	n.咖啡
tea	[ti:]	n.茶
tobacco	[tə'bækəʊ]	n.烟草，烟丝
bird	[bз:d]	n.鸟
any	['eni]	a.一些
some	[sʌm]	a.一些
of course		当然
kettle	['ketl]	n.水壶
behind	[bi'haind]	prep.在...后面
teapot	['ti:pɒt]	n.茶壶
now	[nau]	ad.现在，此刻
find	[faind]	v.找到
boil	[bɒil]	v.沸腾，开
can	[kæn]	aux.v.能够
boss	[bɒs]	n.老板，上司
minute	['minit, mai'nju:t]	n.分(钟)
ask	[a:sk]	v.请求，要求
handwriting	['hændraitıŋ]	n.书写
terrible	['terəbl]	a.糟糕的，可怕的
lift	[lift]	v.拿起，搬起，举起
cake	[keik]	n.饼，蛋糕
biscuit	['biskit]	n.饼干
like	[laik]	v.喜欢，想要
want	[wɒnt]	v.想
fresh	[freʃ]	a.新鲜的
egg	[eg]	n.鸡蛋
butter	['bʌtə]	n.黄油
pure	[pjuə]	a.纯净的
honey	['hʌni]	n.蜂蜜
ripe	[raip]	a.成熟的
banana	[bə'na:nə]	n.香蕉
jam	[dʒæm]	n.果酱
sweet	[swi:t]	a.甜的
orange	['ɒrindʒ]	n.橙
Scotch whisky		苏格兰威士忌
choice	[tʃɒis]	a.上等的，精选的
apple	['æpl]	n.苹果
wine	[wain]	n.酒，果酒
beer	[bıə]	n.啤酒
blackboard	['blækbɒ:d]	n.黑板
butcher	['butʃə]	n.卖肉的
meat	[mi:t]	n. (食用) 肉
beef	[bi:f]	n.牛肉
lamb	[læm]	n.羔羊肉
husband	['hʌzbənd]	n.丈夫
steak	['steik]	n.牛排
mince	[mins]	n.肉馅，绞肉
chicken	['tʃikin]	n.鸡
tell	[tel]	v.告诉
truth	[tru:ð]	n.实情
either	['aiθə, 'i:θə]	ad.也
tomato	[tə'ma:təʊ]	n.西红柿
potato	[pəʊ'teitəʊ]	n.土豆
cabbage	['kæbidʒ]	n.卷心菜
lettuce	['letis]	n.莴苣
pea	[pi:]	n.豌豆
bean	[bi:n]	n.豆角
pear	[pAə]	n.梨
grape	[greip]	n.葡萄
peach	[pi:tʃ]	n.桃
Greece	[gri:s]	n.希腊
climate	['klaimit]	n.气候
country	['kʌntri]	n.国家; 乡村
pleasant	['pleznt]	a.宜人的
weather	['weθə]	n.天气
spring	[sprıŋ]	n.春季
windy	['windi]	a.有风的
warm	[wɒ:m]	a.温暖的
rain	[rein]	v.下雨
sometimes	['sʌmtaimz]	ad.有时
summer	['sʌmə]	n.夏天
autumn	['ɒ:təm]	n.秋天
winter	['wintə]	n.冬天
snow	[snəʊ]	v.下雪
January	['dʒænjuəri]	n.一月
February	['februəri]	n.二月
March	[mα:tʃ]	n.三月
April	['eiprəl]	n.四月
May	[mei]	n.五月
June	[dʒu:n]	n.六月
July	[dʒu'lai]	n.七月
August	[ɒ:'gʌst]	n.八月
September	[səp'tembə]	n.九月
October	[ɒk'təʊbə]	n. 十月
November	[nəʊ'vembə]	n.十一月
December	[di'sembə]	n.十二月
the U.S.		美国
Brazil	[brə'zil]	n.巴西
Holland	['hɒlənd]	n.荷兰
England	['inglənd]	n.英国
France	[frα:ns]	n.法国
Germany	['dʒз:məni]	n.德国
Italy	['itəli]	n.意大利
Norway	['nɒ:wei]	n.挪威
Russia	['rʌʃə]	n.俄罗斯
Spain	[spein]	n.西班牙
Sweden	['swi:dn]	n.瑞典
mild	[maild]	a.温和的，温暖的
always	['ɒ:lweiz, 'ɒ:lwəz]	ad.总是
north	[nɒ:ð]	n.北方
east	[i:st]	n.东方
wet	[wet]	a.潮湿的
west	[west]	n.西方
south	[sauð]	n.南方
season	['si:zn]	n.季节
best	[best]	a. 最好的；ad.最，最好地
night	[nait]	n.夜晚
rise	[raiz]	v.升起
early	['з:li]	ad.早
set	[set]	v. (太阳)落下去
late	[leit]	ad.晚，迟
interesting	['intristıŋ]	a.有趣的，有意思的
subject	['sʌbdʒikt, sʌb'dʒekt]	n.话题，主题
conversation	['kɒnvə'seiʃən]	n.谈话
Australia		n.澳大利亚
Australian		n.澳大利亚人
Austria		n.奥地利
Austrian		n.奥地利人
Canada		n.加拿大
Canadian		n.加拿大人
China		n.中国
Finland		n.芬兰
Finnish		n.芬兰人
India		n.印度
Indian		n.印度人
Japan		n.日本
Nigeria		n.尼日利亚
Nigerian		n.尼日利亚人
Turkey	['tз:ki]	n.土耳其
Turkish		n.土耳其人
Korea		n.韩国
Polish	['pɒliʃ]	n.波兰人
Poland		n.波兰
Thai		n.泰国人
Thailand		n.泰国
live	[liv' laiv]	v.住，生活
stay	[stei]	v.呆在，停留
home	[həʊm]	n.家；ad.在家，到家
housework	['hauswз:k]	n.家务
lunch	[lʌntʃ]	n.午饭
afternoon	['a:ftə'nu:n]	n.下午
usually	['ju:ʒuəli]	ad.通常
together	[tə'geθə]	ad.一起
evening	['i:vnıŋ]	n.晚上
arrive	[ə'raiv]	v.到达
night	[nait]	n.夜间
o'clock		ad.点钟
shop	[ʃɒp]	n.商店
moment	['məʊmənt]	n.片刻，瞬间
envelope	['enviləʊp]	n.信封
writing paper		信纸
shop assistant		售货员
size	[saiz]	n.尺寸，尺码，大小
pad	[pæd]	n.信笺簿
glue	[glu:]	n.胶水
chalk	[tʃɒ:k]	n.粉笔
change	[tʃeindʒ]	n.零钱，找给的钱；v.兑换(钱)
feel	[fi:l]	v.感觉
look	[luk]	v.看(起来)
call	[kɒ:l]	v.叫，请
doctor	['dɒktə]	n.医生
telephone	['telifəʊn]	n.电话；v.打电话
remember	[ri'membə]	v.记得，记住
mouth	[mauð]	n.嘴
tongue	[tʌŋ]	n.舌头
bad	[bæd]	a.坏的，严重的
cold	[kəʊld]	n.感冒
news	[nju:z]	n.消息
headache	['hedeik]	n.头痛
aspirin	['æspərin]	n.阿斯匹林
earache	['ıəreik]	n.耳痛
toothache	['tu:ðeik]	n.牙痛
dentist	['dentist]	n.牙医
stomach ache		胃痛
medicine	['medisin]	n.药
temperature	['tempəritʃə]	n.温度
flu	[flu:]	n.流行性感冒
measles	['mi:zlz]	n.麻疹
mumps	[mʌmps]	n.腮腺炎
better	['betə]	a.较好的；ad.更好
certainly	['sз:tənli]	ad.当然
get up		起床
yet	[jet]	ad.还，仍
rich	[ritʃ]	a.油腻的
food	[fu:d]	n.食物
remain	[ri'mein]	v.保持，继续
play	[plei]	v.玩
match	[mætʃ]	n.火柴
talk	[tɒ:k]	v.谈话
library	['laibrəri]	n.图书馆
drive	[draiv]	v.开车
so	[səʊ]	ad.如此地
quickly	['kwikli]	ad.快地
lean out of		身体探出
break	[breik]	v.打破
noise	[nɒiz]	n.喧闹声
Dad	[dæd]	n.爸(儿语)
key	[ki:]	n.钥匙
baby	['beibi]	n.婴儿
hear	[hıə]	v.听见
enjoy	[in'dʒɒi]	v.玩得快活，享受......的乐趣
yourself	[jɒ:'self]	pron.你自己
ourselves	['auə'selvz]	pron.我们自己
mum	[mʌm]	妈妈
myself	[mai'self]	pron.我自己
themselves	[θAm'selvz]	pron.他们自己
himself	[him'self]	pron.他自己
herself	[hз:'self]	pron.她自己
greengrocer	['gri:n'grəʊsə]	n.蔬菜水果零售商
absent	['æbsənt, əb'sent]	a.缺席的
Monday	['mʌndi]	n.星期一
Tuesday	['tju:zdi]	n.星期二
Wednesday	['wenzdi]	n.星期三
Thursday	[ðз:zdi]	星期四
keep	[ki:p]	v. (身体健康) 处于 (状况)
spend	[spend]	v.度过
weekend	['wi:kend]	n.周末
Friday	['fraidi]	n.星期五
Saturday	['sætədi]	n.星期六
Sunday	['sʌndi]	n.星期日
country	[ˈkʌntri]	n.乡村
lucky	['lʌki]	a.幸运的
church	[tʃз:tʃ]	n.教堂
dairy	['dAəri]	n.乳品店
baker	['beikə]	n.面包师傅
grocer	['grəʊsə]	n.食品杂货商
year	[jз:, jıə]	n.年
race	[reis]	n.比赛
town	[taun]	n.城镇
crowd	[kraud]	n.人群
stand	[stænd]	v.站立
exciting	[ik'saitıŋ]	a.使人激动的
just	[dʒʌst]	ad.正好，恰好
finish	['finiʃ]	n.结尾，结束
winner	['winə]	n.获胜者
behind	[bi'haind]	prep.在......之后
way	[wei]	n.路途
stationer	['steiʃənə]	文具商
Denmark		n.丹麦
awful	['ɒ:ful]	ad.让人讨厌的，坏的
telephone	['telifəʊn]	v. & n.打电话；电话
time	[taim]	n.次(数)
answer	['a:nsə]	v.接(电话)
last	[la:st]	a.最后的，前一次的
phone	[fəʊn]	n.电话
again	[ə'gein, ə'gen]	ad.又一次地
say	[sei]	(said, said) v.说
week	[wi:k]	n.周
London		n.伦敦
suddenly	['sʌdnli]	ad.突然地
bus stop		公共汽车车站
smile	[smail]	v.微笑
pleasantly	['plezntli]	ad.愉快地
understand	['ʌndə'stænd]	(understood, understood) v.懂，明白
speak	[spi:k]	(spoke, spoke) v.讲，说
hand	[hænd]	n.手
pocket	['pɒkit]	n.衣袋
phrasebook		n.短语手册，常用语手册
phrase	[freiz]	n.短语
slowly	['sləʊli]	ad.缓慢地
hurriedly		ad.匆忙地
cut		v.割，切(cut, cut)
thirstily	['ðз:stili]	ad.口渴地
go	[gəʊ]	(went, gone) v.走
greet	[gri:t]	v.问候，打招呼
ago	[ə'gəʊ]	ad.以前
buy	[bai]	(bought, bought) v.买
pair	[pAə]	n.双，对
fashion	['fæʃən]	n. (服装的) 流行式样
uncomfortable	[ʌn'kʌmfətəbl]	a.不舒服的
wear	[wAə]	(wore, wore) v.穿着
appointment	[ə'pɒintmənt]	n.约会，预约
urgent	['з:dʒənt]	a.紧急的，急迫的
till	[til]	prep.直到......为止
shopping	['ʃɒpıŋ]	n.购物
list	[list]	n.单子
vegetable	['vedʒitəbl]	n.蔬菜
need	[ni:d]	v.需要
hope	[həʊp]	v.希望
thing	[ðıŋ]	n.事情
money	['mʌni]	n.钱
groceries		n.食品；杂货
fruit	[fru:t]	n.水果
stationery	['steiʃənəri]	n.文具
newsagent	['nju:zeidʒənt]	n.报刊零售人
chemist	['kemist]	n.药剂师，化学家
bath	[ba:ð]	n.洗澡
nearly	['nıəli]	ad.几乎，将近
ready	['redi]	a.准备好的，完好的
dinner	['dinə]	n.正餐，晚餐
restaurant	['restərɒnt]	n.饭馆，餐馆
roast	[rəʊst]	a.烤的
breakfast	['brekfəst]	n.早饭
haircut	['hAəkʌt]	n.理发
party	['pa:ti]	n.聚会
holiday	['hɒlədi]	n.假日
mess	[mes]	n.杂乱，凌乱
pack	[pæk]	v.包装，打包，装箱
suitcase	['sju:tkeis]	n.手提箱
leave	[li:v]	(left, left) v.离开
already	[ɒ:l'redi]	ad.已经
Paris		n.巴黎
cinema	['sinimə]	n.电影院
film		n.电影
beautiful	['bju:tiful]	a.漂亮的
city	['siti]	n.城市
never	['nevə]	ad.从来没有
ever	['evə]	ad.在任何时候
attendant	[ə'tendənt]	n.接待员
bring	[brıŋ]	(brought, brought) v.带来，送来
garage	['gæra:ʒ]	n.车库，汽车修理厂
crash	[kræʃ]	n.碰撞
lamp-post		n.灯杆
repair	[ri'pAə]	v.修理
try	[trai]	v.努力，设法
believe	[bi'li:v]	v.相信，认为
may	[mei]	modal verb(用于请求许可)可以
how long		多长
since	[sins]	prep.自从
why	[wai]	ad.为什么
sell	[sel]	(sold, sold) v.卖，出售
because	[bi'kɒz]	conj.因为
retire	[ri'taıə]	v.退休
cost	[kɒst]	(cost, cost) v.花费
pound		n.英镑(￡)
worth	[wз:ð]	prep.值......钱
penny	['peni]	n.便士
still	[stil]	ad.还，仍旧
move	[mu:v]	v.搬家
miss	[mis]	v.想念，思念
neighbour	['neibə]	n.邻居
person	['pз:sn]	n.人
people	['pi:pl]	n.人们
poor	[puə]	a.可怜的；贫穷的
pilot	['pailət]	n.飞行员
return	[ri'tз:n]	v.返回；n.往返
New York		n.纽约
Tokyo		n.东京
Madrid		n.马德里
fly	[flai]	(flew, flown) v.飞行
Athens		n.雅典
Berlin		n.柏林
Bombay		n.孟买
Geneva	[dʒi'ni:və]	n.日内瓦
Moscow		n.莫斯科
Rome		n.罗马
Seoul		n.汉城
Stockholm		n.斯德哥尔摩
Sydney		n.悉尼
return	[ri'tз:n]	n.往返
train	[trein]	n.火车
platform	['plætfɒ:m]	n.站台
plenty	['plenti]	n.大量
bar	[ba:]	n.酒吧
station	['steiʃən]	n.车站，火车站
porter	['pɒ:tə]	n.收票员
catch	[kætʃ]	(caught, caught) v.赶上
miss	[mis]	v.错过
leave	[li:v]	(left)v.遗留
describe	[dis'kraib]	v.描述
zip	[zip]	n.拉链
label	['leibl]	n.标签
handle	['hændl]	n.提手，把手
address	[ə'dres]	n.地址
pence	[pens]	n. penny的复数形式
belong	[bi'lɒŋ]	v.属于
ow	[au]	int.哎哟
slip	[slip]	v.滑倒，滑了一脚
fall	[fɒ:l]	(fell, fallen) v.落下，跌倒
downstairs	['daun'stAəz]	ad.下楼
hurt	[hз:t]	(hurt, hurt) v.伤，伤害，疼痛
back	[bæk]	n.背
stand up		起立，站起来
help	[help]	v.帮助
at once		立即
sure	[ʃuə]	a.一定的，确信的
X-ray		n. X光透视
licence	[ˈlaɪsns]	n.执照
Scotland		n.苏格兰
card	[ka:d]	n.明信片
youth	[ju:ð]	n.青年
hotel	[həʊ'tel]	n.招待所，旅馆
association	[ə'səʊsi'eiʃən]	n.协会
soon	[su:n]	ad.不久
write	[rait]	(wrote, written) v.写
exam	[ig'zæm]	n.考试
pass	[pa:s]	v.及格，通过
mathematics	['mæði'mætiks]	n.数学 (maths 是缩写)
question	['kwestʃən]	n.问题
easy	['i:zi]	a.容易的
enough	[i'nʌf]	a.足够的；ad.足够地
paper	['peipə]	n.考卷
fail	[feil]	v.未及格，失败
answer	['a:nsə]	v.回答
mark	[ma:k]	n.分数
rest	[rest]	n.其他的东西
difficult	['difikəlt]	a.困难的
hate	[heit]	v.讨厌
low	[ləʊ]	a.低的，矮的
cheer	[tʃıə]	v.振作，振奋
guy	[gai]	n.家伙，人
top	[tɒp]	n.上方，顶部
clever	['klevə]	a.聪明的
stupid	['stju:pid]	a.笨的
cheap	[tʃi:p]	a.便宜的
expensive	[iks'pensiv]	a.贵的
stale	[steil]	a.变馊的
loud	[laud]	a.大声的
high	[hai]	a.高的
hard	['ha:d]	a.硬的
sweet	[swi:t]	a.甜的
soft	[sɒft]	a.软的
sour	['sauə]	a.酸的
spell	[spel]	(spelt, spelt) v.拼写
intelligent	[in'telidʒənt]	a.聪明的，有智慧的
mistake	[mis'teik]	n.错误
present	['preznt]	n.礼物
dictionary	['dikʃənəri]	n.词典
carry	['kæri]	v.携带
correct	[kə'rekt]	v.改正，纠正
keep	[ki:p]	v.保存，保留
madam	['mædəm]	n.夫人，女士(对妇女的尊称)
smart	[sma:t]	a.漂亮的
as well		同样
suit	[sju:t]	v.适于
pretty	['priti]	a.漂亮的
idea	[ai'dıə]	n.主意
a little		少许
teaspoonful	['ti:spu:n'ful, -spun-]	n.一满茶匙
less	[les]	a.较少的，更小的
a few		几个
pity	['piti]	n.遗憾
instead	[in'sted]	ad.代替
advice	[əd'vais]	n.建议，忠告
most	[məʊst]	最多的
least	[li:st]	最小的，最少的
best	[bɛst]	a.(good的最高级)最好的
worse	[wз:s]	更坏的
worst	[wз:st]	a.最坏的
model	['mɒdl]	n.型号，式样
afford	[ə'fɒ:d]	v.付得起(钱)
deposit	[di'pɒzit]	n.预付定金
installment	[in'stɒ:lmənt]	n.分期付款
price	[prais]	n.价格
millionaire	['miljə'nAə]	n.百万富翁
conductor	[kən'dʌktə]	n.售票员
fare	[fAə]	n.车费，车票
change	[tʃendʒ]	v.兑换(钱)
note	[nəʊt]	n.纸币
passenger	['pæsindʒə]	n.乘客
none	[nʌn]	pron.没有任何东西
neither	['naiθə, 'ni:θə]	ad.也不
get off		下车
tramp	[træmp]	n.流浪汉
except	[ik'sept]	prep.除……外
anyone	['eniwʌn]	pron.任何人
knock	[nɒk]	v.敲，打
everything	['evriðıŋ]	pron.一切事物
quiet	['kwaıət]	a.宁静的，安静的
impossible	[im'pɒsəbl]	a.不可能的
invite	[in'vait]	v.邀请
anything	['eniðıŋ]	pron.任何东西
nothing	['nʌðıŋ]	pron.什么也没有
lemonade	['lemə'neid]	n.柠檬水
joke	[dʒəʊk]	v.开玩笑
asleep	[ə'sli:p]	a.睡觉，睡着
glasses		n.眼镜
dining room		饭厅
coin	[kɒin]	n.硬币
mouth	[mauð]	n.嘴
swallow	['swɒləʊ]	v.吞下
later	['leitə]	ad.后来
toilet	['tɒilit]	n.厕所，盥洗室
ring	[rıŋ]	v.响
story	['stɒ:ri]	n.故事
happen	['hæpən]	v.发生
thief	[ði:f]	n.贼
enter	['entə]	v.进入
dark	[da:k]	a.黑暗的
torch	[tɒ:tʃ]	n.手电筒
voice	[vɒis]	n. (说话的) 声音
parrot	['pærət]	n.鹦鹉
exercise book		练习本
customer		n.顾客
forget	[fə'get]	(fogot, fogotten) v.忘记
manager	['mænidʒə]	n.经理
serve	[sз:v]	v.照应，服务，接待
counter	['kauntə]	n.柜台
recognize	['rekəgnaiz]	v.认识
road	[rəʊd]	n.路
during	['djuərıŋ]	prep.在......期间
trip	[trip]	n.旅行
travel	['trævl]	v.旅行
offer	['ɒfə]	v.提供
job	[dʒɒb]	n.工作
guess	[ges]	v.猜
grow	[grəʊ]	(grew, grown) v.长，让......生长
beard	[bıəd]	n. (下巴上的) 胡子，络腮胡子
kitten	['kitn]	n.小猫
water	['wɒ:tə]	v.浇水
terribly	['terəbli]	ad.非常
dry	[drai]	a.干燥的，干的
nuisance	['nju:sns]	n.讨厌的东西或人
mean	[mi:n]	(meant, meant) v.意味着，意思是
surprise	[sə'praiz]	n.惊奇，意外的事
immediately	[i'mi:djətli]	ad.立即地
famous	['feiməs]	a.著名的
actress	['æktris]	n.女演员
at least		至少
actor	['æktə]	n.男演员
read	[ri:d]	(read, read) v.通过阅读得知
wave	[weiv]	v.招手
track	[træk]	n.跑道
mile	[mail]	n.英里
overtake	['əʊvə'teik]	(overtook, overtaken) v.从后面超越，超车
speed limit		限速
dream	[dri:m]	v.做梦，思想不集中
sign	[sain]	n.标记，牌子
driving licence		驾驶执照
charge	[tʃa:dʒ]	v.罚款
darling	['da:lıŋ]	n.亲爱的(用作表示称呼)
Egypt		n.埃及
abroad	[ə'brɒ:d]	ad.国外
worry	['wʌri]	v.担忧
reporter	[ri'pɒ:tə]	n.记者
sensational	[sen'seiʃənl]	a.爆炸性的，耸人听闻的
mink coat		貂皮大衣
future	['fju:tʃə]	a.未来的
get married		结婚
hotel	[həʊ'tel]	n.饭店
latest	['leitist]	a.最新的
introduce	['intrə'dju:s]	v.介绍
football	['futbɒ:l]	n.足球
pool	[pu:l]	n.赌注
win	[win]	(won, won) v.赢
world	[wз:ld]	n.世界
poor	[pɔ:r]	n.赌注
depend	[di'pend]	v.依靠
extra	['ekstrə]	a.额外的
overseas	['əʊvə'si:z]	a.海外的，国外的
engineering	['endʒi'nıərıŋ]	n.工程
company	['kʌmpəni]	n.公司
line	[lain]	n.线路
excited		a.兴奋的
get on		登上
middle-aged		a.中年的
opposite	['ɒpəzit]	prep.在......对面
curiously	['kjuərıəsli]	ad.好奇地
funny	['fʌni]	a.可笑的，滑稽的
powder	['paudə]	n.香粉
compact	['kɒmpækt, kəm'pækt]	n.带镜的化妆盒
kindly	['kaindli]	ad.和蔼地
ugly	['ʌgli]	a.丑陋的
amused	[ə'mju:zd]	a.有趣的
smile	[smail]	v.微笑
embarrassed		a.尴尬的，窘迫的
worried	['wʌrid]	a.担心，担忧
regularly	['regjuləli]	ad.经常地，定期地
surround	[sə'raund]	v.包围
wood	[wud]	n.树林
beauty spot		风景点
hundred	['hʌndrid]	n.百
city	['siti]	n.城市
through	[ðru:]	prep.穿过
visitor	['vizitə]	n.参观者，游客，来访者
tidy	['taidi]	a.整齐的
litter	['litə]	n.杂乱的东西
litter basket		废物筐
place	[pleis]	v.放
throw	[ðrəʊ]	(threw, thrown) v.扔，抛
rubbish	['rʌbiʃ]	n.垃圾
count	[kaunt]	v.数，点
cover	['kʌvə]	v.覆盖
piece	[pi:s]	n.碎片
tyre	['taıə]	n.轮胎
rusty	['rʌsti]	a.生锈的
among	[ə'mʌŋ]	prep.在......之间
prosecute	['prɒsikju:t]	v.依法处置